18 18 18 30 0 15 17 0 28 18 18 18 18 18 24 29 22 66 65 68 28 18 18 18 18 18 18 18 18 18 18 24 29 29 29 23 18 18 18 18 18 24 29 23 18 24 29 29 23 18 
18 18 18 30 0 15 17 0 28 18 18 18 18 24 22 0 0 0 0 20 26 18 18 24 29 29 23 18 18 24 29 22 0 0 0 28 18 18 18 18 24 22 0 21 29 22 0 0 21 29 
18 18 24 22 0 15 17 0 21 29 29 23 18 30 0 0 0 20 27 26 18 18 18 25 19 0 21 29 29 22 0 0 0 0 0 21 23 18 24 29 22 0 0 0 0 0 0 0 0 69 
18 18 30 0 0 15 17 0 0 0 0 21 29 22 0 0 0 28 18 18 18 18 24 29 22 0 0 0 0 0 0 0 0 0 0 0 21 29 22 0 0 0 0 0 0 0 0 0 0 67 
18 18 25 19 0 8 71 6 0 0 0 0 0 0 0 0 0 28 18 18 18 18 30 0 0 0 0 7 14 14 14 14 14 6 0 0 0 0 0 0 0 0 0 33 40 40 40 32 20 27 
18 18 18 25 19 0 8 71 14 14 14 6 0 0 0 0 0 21 29 29 23 18 30 0 0 7 14 72 16 16 16 16 16 71 6 0 0 0 0 0 33 40 40 39 31 57 37 35 21 23 
18 18 18 18 30 0 0 8 16 16 16 71 14 6 0 0 0 0 0 0 21 29 22 0 7 72 16 9 0 0 0 0 0 8 71 6 0 0 0 33 39 31 31 31 31 31 38 32 44 21 
18 18 18 18 25 19 0 0 0 0 0 8 16 71 14 6 0 0 0 0 0 0 0 7 72 9 0 0 33 40 32 0 0 0 15 17 0 0 33 39 57 31 56 31 31 31 31 38 32 69 
18 18 18 18 18 30 0 0 0 0 0 0 0 8 16 71 14 14 14 14 14 14 14 72 9 0 33 40 39 57 38 32 0 0 15 17 0 0 34 42 36 31 31 31 31 31 55 31 43 70 
18 24 29 29 29 22 0 0 0 0 0 0 0 0 0 8 16 16 16 16 16 16 16 9 0 0 41 31 31 31 31 43 0 0 15 17 0 0 0 0 41 31 31 31 31 56 31 31 43 70 
18 30 0 0 0 0 0 0 0 0 0 0 0 0 0 0 0 0 0 0 0 0 0 0 0 0 34 36 55 31 31 38 32 0 15 17 0 0 0 0 34 36 59 31 31 37 42 42 35 67 
18 30 0 20 27 27 27 27 19 0 0 0 0 0 0 0 0 0 0 0 0 20 19 0 0 0 0 34 36 31 31 56 43 0 8 71 6 0 0 0 0 34 42 42 42 35 0 0 20 27 
18 30 0 28 18 18 18 18 25 19 0 0 0 0 0 0 0 0 0 20 27 26 25 27 19 0 0 0 41 58 31 31 43 0 0 8 71 6 0 0 0 0 0 0 0 0 0 0 28 18 
18 30 0 28 18 18 18 18 24 22 0 0 0 0 0 0 0 0 0 28 18 18 18 18 25 19 0 33 39 31 59 37 35 0 0 0 8 71 14 14 6 0 0 0 0 0 0 20 26 18 
24 22 0 28 18 18 18 18 30 0 0 0 0 0 0 0 0 20 27 26 18 18 18 18 18 30 0 41 57 31 37 35 0 0 7 14 14 72 16 16 71 6 0 0 0 0 0 28 18 18 
30 0 0 28 18 18 18 24 22 0 0 0 0 0 0 0 0 28 24 29 23 24 29 23 18 30 0 34 42 42 35 0 0 7 72 16 16 9 0 0 8 71 6 0 0 0 0 21 23 18 
25 27 27 26 18 18 24 22 0 0 0 0 0 0 0 0 0 21 22 0 28 30 0 21 23 30 0 0 0 0 0 0 0 15 17 0 0 0 0 0 0 15 17 0 0 0 0 20 26 18 
18 18 18 18 18 24 22 0 0 0 0 0 0 0 0 0 0 0 0 0 28 30 0 0 21 22 0 0 0 0 7 14 14 72 9 0 0 0 0 0 0 8 71 6 0 0 0 21 23 18 
18 18 18 18 18 30 0 0 0 0 0 0 0 0 0 0 0 0 20 27 26 30 0 0 0 0 0 0 0 7 72 16 16 9 0 0 0 0 0 0 0 0 8 71 6 0 0 0 21 23 
18 18 18 18 24 22 0 0 0 0 0 0 20 19 0 20 27 27 26 18 24 22 0 0 0 0 0 0 7 72 9 0 0 0 0 0 0 0 0 0 0 0 0 15 17 0 0 0 0 28 
18 18 18 18 30 0 0 0 0 0 0 0 28 30 20 26 18 18 18 24 22 0 0 0 0 0 0 0 15 17 0 0 0 0 0 0 0 0 0 0 0 0 0 15 17 0 0 0 0 28 
29 23 24 29 22 0 33 40 40 40 32 0 28 25 26 18 24 29 29 22 0 0 0 0 0 0 0 0 15 17 0 0 0 0 0 20 27 27 19 0 0 0 0 15 17 0 0 0 20 26 
32 21 22 33 40 40 39 31 31 58 43 0 21 23 18 24 22 0 0 0 0 0 0 0 7 14 14 14 72 9 0 0 0 0 20 26 18 18 30 0 0 0 0 15 17 0 0 0 28 18 
38 40 40 39 31 31 31 55 31 31 38 40 32 28 24 22 0 0 0 7 14 14 14 14 72 16 16 16 9 0 0 0 0 20 26 18 18 18 18 19 0 0 0 15 17 0 0 20 26 18 
42 42 42 42 42 42 36 31 31 56 31 31 43 21 22 0 0 0 7 72 16 16 16 16 9 0 0 0 44 0 0 0 3 28 18 18 18 18 18 30 0 0 7 72 9 0 0 28 18 18 
27 27 19 0 0 0 34 42 42 42 36 57 43 0 0 0 0 7 72 9 0 0 0 0 0 0 2 0 0 0 0 0 0 21 23 18 18 18 18 30 0 0 15 17 0 0 0 28 18 18 
24 29 22 0 0 0 0 0 0 0 34 42 35 0 7 14 14 72 9 0 0 20 27 27 19 0 0 53 64 65 65 65 65 68 28 18 24 29 29 22 0 0 15 17 0 0 0 21 23 18 
30 0 0 0 0 0 7 14 6 0 0 0 0 7 72 16 16 9 0 0 0 28 18 18 25 27 27 19 67 2 0 0 4 0 21 29 22 0 0 0 0 7 72 9 0 0 0 0 28 18 
30 0 0 0 0 0 8 16 71 14 14 6 7 72 9 0 0 0 0 20 27 26 18 18 18 18 18 25 19 0 0 1 0 0 0 0 0 0 0 0 7 72 9 0 0 0 0 20 26 18 
30 0 20 27 27 19 0 0 8 16 16 71 72 9 0 0 20 27 27 26 18 18 18 18 18 18 18 18 30 0 0 7 14 14 14 14 14 14 14 14 72 9 0 20 27 27 27 26 18 18 
30 0 28 18 18 25 27 19 0 0 0 8 9 0 0 20 26 18 18 18 18 18 18 24 29 23 18 18 30 52 0 15 11 16 16 16 16 16 16 16 9 0 20 18 18 18 18 18 18 18 
25 27 26 18 18 18 18 25 19 0 0 0 0 0 20 26 18 18 18 18 18 18 18 30 4 21 23 18 30 4 0 15 17 0 0 4 0 0 44 0 0 51 28 18 18 18 18 18 18 18 
18 18 18 18 18 18 18 18 25 27 27 27 27 27 26 18 18 18 18 18 18 18 18 30 0 0 28 24 22 0 0 15 17 0 0 0 0 0 0 20 27 27 26 18 18 18 18 18 18 18 
18 18 18 18 18 18 18 18 18 18 18 18 18 18 18 18 18 18 18 18 18 18 18 30 46 0 21 22 54 0 3 15 17 46 0 0 2 0 54 28 18 18 18 18 18 18 18 18 18 18 
18 18 18 18 18 18 18 18 18 18 18 18 18 18 18 18 18 18 18 18 18 18 18 30 0 0 0 0 0 0 0 15 17 0 0 0 0 0 0 21 29 23 18 18 18 18 18 18 18 18 
18 18 18 18 18 18 18 18 18 18 18 18 18 18 18 18 18 18 18 18 18 18 18 30 0 4 0 0 46 0 0 15 17 0 44 4 0 0 48 0 0 28 18 24 29 29 23 18 18 18 
18 18 18 18 18 18 24 29 29 29 23 18 18 18 18 18 18 18 18 18 18 18 18 30 0 0 0 7 14 14 14 72 9 0 0 0 0 0 0 0 0 28 24 22 51 0 21 23 18 18 
18 18 18 18 18 24 22 50 0 0 21 23 18 18 18 18 18 18 18 18 18 18 24 22 48 0 7 72 16 16 16 9 0 2 0 0 4 0 45 0 52 21 22 0 0 0 47 21 23 18 
18 18 24 29 29 22 0 0 0 46 0 21 23 18 18 18 18 18 18 18 18 18 30 0 0 0 15 17 0 0 0 0 0 0 0 49 0 0 0 0 2 0 0 0 1 0 0 0 28 18 
18 18 30 45 0 0 47 0 0 0 3 0 21 29 29 23 18 18 18 18 18 18 30 0 0 7 72 9 3 0 0 0 20 27 27 19 51 20 19 0 0 0 0 0 0 0 2 0 28 18 
18 18 30 0 0 4 0 0 52 0 0 0 45 0 0 21 29 29 29 29 29 29 22 2 7 72 9 0 0 0 52 0 21 23 18 25 27 26 30 0 0 44 0 0 0 0 52 0 28 18 
18 24 22 48 0 7 14 14 14 6 54 0 1 0 0 3 0 0 46 0 54 0 0 0 15 17 0 0 0 33 32 0 48 21 29 23 18 18 30 48 0 0 0 0 54 0 0 20 26 18 
18 30 0 0 46 15 5 5 5 12 14 14 14 14 14 14 14 14 14 14 14 14 14 14 72 9 0 45 0 41 38 32 0 2 0 28 18 18 25 19 0 2 0 0 0 0 20 26 18 18 
18 30 0 1 0 15 5 5 5 11 16 16 16 16 16 16 16 16 16 16 16 16 16 16 9 3 33 40 40 39 31 43 0 0 4 28 18 18 18 25 19 0 0 1 45 0 28 18 18 18 
18 25 19 0 0 8 16 16 16 9 0 0 3 0 0 0 47 0 52 0 0 45 0 0 0 0 41 31 31 31 58 38 32 44 20 26 18 18 18 18 30 0 0 0 0 51 21 29 23 18 
18 18 30 45 0 48 0 4 0 53 0 0 0 20 27 27 27 27 27 27 27 27 19 0 0 3 34 36 55 31 31 59 43 1 28 18 18 18 18 18 30 46 0 0 2 0 0 0 28 18 
18 18 30 0 3 0 0 0 46 0 20 27 27 26 18 18 18 18 18 18 18 18 30 53 0 0 4 34 42 42 36 37 35 0 28 18 18 18 18 24 22 0 0 0 0 53 0 0 28 18 
18 18 25 27 19 51 0 20 27 27 26 18 18 18 18 18 18 18 18 18 18 18 25 27 27 19 0 0 46 1 34 35 1 20 26 18 18 18 24 22 0 4 0 0 0 0 0 20 26 18 
18 18 18 18 25 27 27 26 18 18 18 18 18 18 18 18 18 18 18 18 18 18 18 18 18 25 27 27 27 19 0 50 0 28 18 18 18 18 25 27 27 19 0 48 0 20 27 26 18 18 
18 18 18 18 18 18 18 18 18 18 18 18 18 18 18 18 18 18 18 18 18 18 18 18 18 18 18 18 18 25 27 27 27 26 18 18 18 18 18 18 18 25 27 27 27 26 18 18 18 18 
